.....####...............................
........................................
........................................
........................................
........................................
........................................
........####............................
...........#.................#..........
...........#.................#..........
...........#.................#..........
...........#.................#..........
...........#.................#..........
.............................#..........
.............................#..........
.............................#..........
.............................#..........
.............................#..........
.............................#..........
.............................#..........
.............................#..........
........................................
........................................
........................................
........................................
........................................
........................................
...........###############..............
...........###############..............
...........###############..............
...........###############..............
...........###############..............
...........###############..............
...........###############..............
........................................
........................................
........................................
.........###############................
........................................
........................................
........................................