.....####...............................
........................................
........................................
........................................
........................................
........................................
........########........................
...........#.............#########......
...........#.................#..........
...........#.................#..........
...........#.................#..........
...........#.................#..........
.............................#..........
.............................#..........
.............................#..........
.............................#..........
.............................#..........
.............................#..........
.............................#..........
.............................#..........
........................................
........................................
........###########################.....
........###########################.....
........................................
........................................
...........###############..............
...........###############..............
...........###############..............
...........###############..............
...........###############..............
...........###############..............
...........###############..............
........................................
........................................
........................................
.........###############................
........................................
........................................
........................................